8 7
5 4
EXXXXXX
      X
XX XX X
X  XX X
X XXXXX
X    XX
XXXXXXX
XXXXXXX